3,15;6,20;16,20;20,12;15,5;11,3;9,12
7,45;13,45;10,25
35,45;41,45;41,30;35,30
38,12;41,15;44,12;43,5;40,5
13,2;16,3;21,10;21,0;12,0
0,16;2,16;2,14;0,14
35,48;47,48;47,31;44,31;44,46;35,46
